##############################
##############################
#                            #
# ## ## ## ## ## ######## ## #
# ## ## ## ## ######## ## ## #
# ##       ##             ## #
# ## ## ## ######## ## ## ## #
# ## ## ## ## ##### ## ## ## #
#    ## ## ##    ##    ##    #
# ##### ## ## ## ## ## ## ## #
# ##### ## ## ## ## ## ## ## #
#  #    ##    ##    ##  #    #
# ## ##### ## ##### ## ## ## #
# ## ##### ## ##### ## ## ## #
#       ## ##          #     #
# ## ## ## ## ## ##### ## ## #
# ## ## ## ##### ##### ## ## #
#       ##E##          ##    #
# ## ##### ## ##### ## ## ####
# ## ##### ## ##### ## ## ## #
#          ##       ##       #
# ## ##### ##### ## ## ## ## #
# ## A#### ## ## ## ## ## ## #
#                ##          #
# ##### ## ## ## ## ## ##### #
# ##### ##### ## ## ## ##### #
#                   ##       #
# ## ##### ##### ## ##### ## #
# ## ##### ##### ## ##### ## #
#                         #  #
##############################
