#############################################
#############################################
# ##          #   #                ##       #
# ## ## ## ## ## ## ## ## ## ##### ## ## ## #
# ## ## ## ## ## ## ## ## ## ##### ## ## ## #
#E   ##       ##                ##    #  ## #
# ## ## ## ## ## ##### ##### ## ## ## ## ## #
# ## ## ## ## ## ##### ##### ## ## ## ## ## #
#    ##             ##                ##    #
####### ## ## ## ## ## ########### ## ## ## #
####### ## ## ## ## ## ##A######## ## ## ## #
#    ## ## ##    ## ##                      #
# ## ## ## ######## ## ## ##### ######## ## #
# ##### ## ######## ## ## ##### ######## ## #
#    ## ## ##    ##    ##    ##             #
#### ## ## ## ## ## ## ## ## ##### ## ##### #
#### ## ## ## ## ## ## ## ## ##### ######## #
#       ## ##             ##    ##       ## #
# ##### ## ## ################# ######## ## #
# ##### ## ## ################# ######## ## #
#          ##             ##    ##    ## #  #
# ## ##### ## ## ## ## ## ## ##### ## ## ## #
# ## ##### ## ## ## ## ## ## ##### ## ## ## #
#    #   #    ##       ##  # ##  # ## ##    #
#### ## ## ##### ##### ##### ## ## ## ##### #
# ## ## ## ##### ##### ##### ##### ## ##### #
#     #          ##       ##    ## ##       #
# ##### ## ## ## ## ##### ##### ## ######## #
# ##### ## ## ## ## ## ## ##### ## ######## #
#                      ## #  ## ##       ## #
# ## ######## ########### ## ## ######## ## #
# ## ######## ## ######## ## ## ######## ## #
#             ## ##       ## ## ##    ## ## #
# ######## ## ## ## ######## ## ## ## ## ## #
# ######## ## ## ## ######## ## ## ##### ## #
#             ## ## ##       ## ##          #
# ## ## ## ##### ## ########### ## ## ##### #
# ## ## ## ##### ## ########### ## ## ##### #
#       ##    ## ##             #     ##    #
# ## ## ##### ## #################### ## ## #
# ## ## ##### ## ## ############## ## ## ## #
#          ## ##    ##             ##       #
# ######## ## ######## ## ## ## ## ## ##### #
# ######## ## ######## ## ## ## ## ## ## ## #
#                      ##       #           #
#############################################
