############################################################
###A########################################################
#          ##               E##  #    #     ##     #       #
# ######## ## ## ## ## ##### ##### ## ##### ## ##### ##### #
# ######## ## ## ## ## ##### ##### ## ######## ##### ##### #
#    ## ##    ##       ## ##    ## ## ##    ##    ## #  ## #
# ## ## ## ## ## ## ##### ##### ## ## ## ## ##### ## ## ## #
# ## ##### ## ## ## ##### ##### ## ## ## ## ## ##### ## ## #
# ##       ##    ##    ##       #  ##    ## ## ##    ##    #
# ## ## ## ########### #################### ## ## ##########
# ## ## ## ## ######## ## ########### ##### ## ## ##########
#       ## ##    ##    ##          ##    ##    ##          #
# ######## ##### ## ############## ####################### #
# ######## ######## ############## ####################### #
#       ##    ##    ##    #      # ##       ##          ## #
####### ##### ## ##### ## ######## ## ##### ## ######## ## #
# ##### ##### ## ##### ## ######## ## ##### ## ######## ## #
#    ##    ## ##       ## ##    ##    #  ##    #  ##    ## #
#### ##### ## ########### ## ## ######## ######## ## ##### #
#### ######## ## ######## ## ## ################# ## ##### #
#    ##    ## ##    #  ##  # ##       ##    ##  # ## ##  # #
# ##### ## ## ##### ######## ######## ## ## ## ## ## ## ## #
####### ## ## ##### ######## ######## ## ## ## ## ## ## ## #
#       ## ##    ## ##    ##    ##    ## ## ## ##    ## ## #
# ############## ## ## ## ######## ##### ## ## ######## ## #
# ##### ######## ## ## ## ######## ## ## ## ## ########### #
# ##  # ##    ## ##  # ##          ## ## ##    ##          #
# ## ## ## ## ## ##### ############## ## ######## ##########
# ##### ## ## ## ##### ################# ## ################
#    #  ## ## ## ##    ##       ##       ##                #
#### ##### ## ## ## ##### ##### ## ####################### #
#### ##### ## ## ## ##### ##### ## ####################### #
#    ##    ##    ##    ##     # ##                         #
# ##### ############## ######## ############################
# ##### ############## ################################### #
#       ##        #    ##             ##     #       ##    #
################### ##### ########### ## ##### ######## ####
# ################# ######## ######## ## ##### ######## ## #
# ##       #     ## ##    ##     #    ##    ##       ## ## #
# ######## ##### ## ## ## ######## ######## ######## ## ## #
# ######## ##### ## ## ## ######## ######## ######## ## ####
#          ##  #    ## ##       ##       ##    ##    ##    #
############# ######## ######## ######## ##### ## ######## #
############# ##### ## ######## ######## ## ######## ##### #
#       #     #     ## #  ##    ##       ## ##    #  ##    #
# ##### ############## ## ## ##### ######## ## ## ##### ####
# ##### ############## ##### ##### ########### ## ##### ####
# ##  #              #    ## ##    ##          ## ##    ## #
# ## #################### ## ## ##### ########### ## ##### #
# ####################### ## ## ##### ########### ## ##### #
#       ##             ## ## ##       ##    ##    ## ##    #
####### ## ########### ##### ########### ## ## ##### ## ####
#### ##### ########### ##### ########### ## ## ##### ## ####
#    ##    ##    ##    #     ##    ##    ## ## ##    ##    #
# ##### ##### ##### ########### ## ## ##### ##### ######## #
# ## ## ##### ##### ########### ## ## ## ## ##### ######## #
# ## ## ##  #       ##    ##    ##    ## ##       ##       #
# ## ## ############## ## ## ########### ########### #######
# ## ## ############## ## ## ####################### ## ## #
#    ##                ##    #                       ##    #
############################################################
