############################################################
###A########################################################
#                         # E##        #                   #
#### ## ##### ## ##### ## ## ## ## ## ## ##### ## ## ##### #
#### ## ##### ## ##### ## ## ## ## ## ## ##### ## ## ## ## #
# ##             #        ## ## ##    ##       ##    ## ## #
# ## ##### ##### ## ## ##### ## ######## ## ## ## ## ## ## #
# ## ##### ##### ## ## ##### ## ######## ## ## ## ## ## ## #
# ## ##    ##     # ##  #    ##    #  ##          ## ## ## #
# ## ## ## ## ##### ## ## ######## ##### ## ## ## ## ## ## #
# ## ## ## ## ## ## ## ## ######## ##### ## ## ##### ## ## #
#    ##       ## ## ## ##       ##  #       ##    ## ## ## #
#### ## ## ## ## ## ## ######## ##### ##### ##### ## ## ## #
# ## ## ## ## ## ## ## ######## ##### ## ## ##### ## ##### #
#          ## ##  # ##  #    ##       ## ##    ## ## ##    #
#### ## ## ## ##### ## ## ############## ## ## ##### ## ####
#### ## ## ## ##### ## ## ################# ## ##### ## ## #
#        #       ##    ##       ##          ##       ## ## #
# ## ## ## ##### ## ## ######## ## ##### ############## ## #
# ## ## ## ##### ## ## ######## ## ##### ################# #
#    ##          #           ##    #              ##    ## #
# ## ## ######## ##### ##### ########### ######## ## ## ## #
# ## ## ######## ##### ##### ########### ######## ## #######
# ##          ##                ##       ##    ## ## ##    #
# ## ## ##### ## ## ##### ##### ## ##### ## ## ## ##### ## #
# ## ## ##### ## ## ##### ##### ## ##### ######## ##### ## #
# ## ##    ##          ## ##          ##       ##    ## ## #
# ## ##### ## ######## ## ## ######## ######## ##### ##### #
# ## ##### ## ######## ## ## ## ## ## ## ##### ##### ##### #
# ##       ##    ##    ##    ## ## ## ##     #    ## ##    #
# ############## ## ########### ## ## ############## ## ####
# ############## ############## ## ## ############## ## ## #
# #  ##       ## ##          ## ## ##    ##          ## ## #
# ## ## ##### ## ## ######## ## ## ##### ## ########### ## #
# ## ## ##### ## ## ######## ##### ##### ## ########### ####
# ## ##    ##    ##    ##    ##    ##  #    ##       ##    #
# ## ##### ########### ## ##### ##### ######## ##### ##### #
# ######## ########### ## ##### ##### ######## ##### ##### #
#       ##    ##       ## ## ##       #  ##  # ##    #  ## #
####### ##### ## ######## ## ########### ## ## ######## ## #
# ##### ##### ##### ## ## ##### ######## ## ## ######## ## #
# ## ## #  ##    ##    ## ##    ##    ## ## ##       ##    #
# ## ## ## ##### ######## ## ##### ## ## ########### #######
# ## ## ## ##### ######## ## ##### ## ## ########### ##### #
# ## ## ## ##  #          ##       ## ##    ##       ##    #
# ## ## ## ## ####################### ##### ## ######## ####
# ## ## ## ## ############## ######## ##### ## ######## ####
# ## ## ## ##       ##    ##       ##    ## ## ##    ##    #
# ## ## ## ######## ## ## ######## ##### ## ## ## ## ##### #
# ## ## ## ######## ## ## ######## ##### ## ## ## ## ## ## #
#    ## ## ##       ## ## ##       #   # ##    ## ##    ## #
####### ## ## ######## ## ## ########### ######## ######## #
# ##### ## ## ######## ## ## ############################# #
# ##    ##    ##    ## ##    ##    ##    ##       ##       #
# ## ########### ## ## ######## ## ## ## ## ##### ## #######
# ## ########### ## ## ######## ## ## ## ## ## ## ## #######
# ## ##       ## ## ## ##    ## ## ## ##    ##    ## #     #
# ## ## ##### ## ## ## ## ## ## ## ## ############## ##### #
# ## ## ##### ## ## ## ## ## ## ## ## ############## ##### #
#  #  #    ##    ##    #  ##    ##  #                #     #
############################################################
