#############################################
#############################################
#                                           #
# ##### ######## ##### ##### ## ## ##### ## #
# ##### ######## ##### ##### ## ##### ## ## #
#                   ##       ##             #
# ## ######## ## ## ## ##### ## ## ## ## ## #
# ## ######## ## ## ## ######## ## ######## #
#  #       ##    ##    ##    ##             #
# ## ##### ## ## ## ##### ## ## ## ## #######
# ## ##### A# ## ## ##### ## ## ## ## ##### #
#    ##                   ##       #  ##    #
# ##### ## ## ######## ## ## ## ## ## ## ## #
# ##### ## ## ##### ## ## ## ## ## ## ## ## #
#    ## ##    ##       ##  #    ## ## ##    #
#### ## ######## ##### ## ## ##### ## ## ## #
# ## ## ############## ## ## ##### ## ##### #
# ## ## ## ##    #        ##       ##       #
# ## ## ## ## ## ######## ##### ## ## #######
# ## ## ## ## ## ######## ## ## ## ## ##### #
# ## ## ## ## ## ##                 #       #
# ## ## ## ## ## ## ######## ## ##### ##### #
# ## ## ## ## ## ## ######## ## ##### ##### #
# ## ## ##    ## ##       ##             ## #
# ## ## ######## ## ## ## ## ##### ##### ## #
# ## ## ## ##### ## ## ## ## ##### ##### ## #
# ##    ##  #    ##                   ##    #
# ########### ##### ##### ## ## ##### #######
# ########### ## ## ##### ## ## ##### #######
# ##       #  ## ##          ##    ## ##    #
# ## ##### ##### ## ## ##### ##### ## ## ## #
# ##### ## ######## ## ########### ## ## ## #
#    ## ##          ##             ## ## ## #
#### ## ## ######## ## ## ## ## ##### ## ## #
#### ## ## ######## ## ## ## ## ## ## ## ## #
#   E## ##             ##       #  ##    ## #
# ##### ## ## ######## ## ##### ########### #
# ##### ## ## ######## ## ##### ########### #
# ##    ## ##  #  #    ##    ##  #    ##    #
# ## ##### ## ## ## ##### ## ##### ## ## ####
# ## ##### ## ## ## ##### ## ##### ## ## ## #
# ##       ##    ##                      ## #
# ######## ## ## ##### ## ##### ## ## ## ## #
# ######## ## ## ##### ## ##### ## ## ## ## #
#                                        #  #
#############################################
