##############################
###A##########################
#                           E#
# ## ## ##### ## ##### ## ## #
# ## ######## ## ##### ## ## #
#             #   #          #
# ## ## ## ## ## ## ##### ## #
#### ## ## ## ## ## ## ## ## #
#                   ##       #
# ## ## ## ## ## ## ## ## ## #
# ## ## ## ## ## ## ## ## ## #
#                            #
# ## ## ######## ## ## ## ## #
# ## ## ## ## ## ## ## ## ## #
#                            #
# ## ## ## ##### ## ## ## ## #
# ## ## ## ## ##### ## ## ## #
#                      ##    #
# ##### ## ## ## ## ## ## ## #
# ## ## ## ## ## ## ## ## ## #
#          #                 #
# ## ##### ## ## ##### ## ## #
# ## ##### ## ## ##### ## ## #
#              #       ##    #
# ## ## ##### ## ## ## ## ## #
# ## ## ##### ## ## ## ## ## #
#    ##          ##          #
# ## ## ## ## ## ## ## ## ## #
# ## ## ## ## ## ## ## ## ## #
#                            #
##############################
