##############################
###############A##############
#          ##    ##          #
########## ## ## ## ##### ## #
########## ## ## ######## ## #
#       ## ## ##             #
# ##### ## ## ########### ## #
# ######## ## ########### ## #
#       ## ## ##   E         #
####### ## ## ## ######## ####
####### ## ## ## ######## ####
#       ## ## ## ##    ##    #
# ######## ## ## ## ## #######
# ## ##### ## ##### ## #######
# ## ##    ##       ##       #
# ## ## #################### #
# ## ## ##### ############## #
# ## ## ## ## ##    ##       #
# ##### ## ## ## ## ## #######
####### ## ## ## ## ## ##### #
#    ## ## ##    ## ##    #  #
# ## ## ## ######## ##### ####
# ## ## ## ######## ##### ####
# ## ## ##        # #  ##    #
#### ## ########### ## ##### #
#### ## ########### ##### ## #
#    ##          ##       ## #
# ############## ########### #
# ############## ########### #
#              #             #
##############################
