########################################################################################################################
########################################################################################################################
#    ##             #        ##                                        ##                                              #
# ## ## ## ##### ## ## ## ## ## ## ## ## ## ## ##### ## ## ## ## ##### ## ## ## ## ## ## ## ## ## ##### ## ## ##### ## #
# ## ## ## ##### ## ## ## ## ## ## ## ## ## ## ##### ##### ## ## ##### ## ## ## ## ## ## ## ## ## ##### ## ## ##### ## #
# ##    ##                                                       ##  # ##             ## ##    ##    ##    ##          #
# ## ## ##### ######## ##### ## ## ## ## ######## ##### ######## ## ## ## ## ## ##### ## ## ##### ## ## ## ## ## ## ## #
# ## ##### ## ############## ## ## ## ## ######## ##### ######## ## ## ##### ## ##### ## ## ##### ## ## ## ## ## ## ## #
#                   ##          ##              #       ##       ##             ##       ##             #  ##       ## #
# ## ## ##### ## ## ## ## ##### ## ## ## ## ## ## ## ## ## ## ## ## ##### ##### ## ######## ## ######## ## ## ##### ## #
# ## ######## ## ## ## ## ##### ## ## ## ## ## ## ## ## ######## ## ##### ##### ## ######## ## ######## ## ## ## ## ## #
#                #  ##          #        ##                   ##          #     ## ##                                  #
# ##### ######## ## ## ##### ## ## ##### ## ##### ## ## ##### ## ##### ## ## ## ## ## ########### ## ## ########### ## #
# ##### ######## ## ## ##### ## ## ##### ## ##### ## ## ## ## ## ##### ## ## ## ## ## ########### ## ## ########### ## #
#    ##       ##     #       ##             ##    ##    ##    ##       ##       ##    ##          ##              #    #
# ## ## ##### ## ##### ## ## ######## ## ## ## ## ## ## ## ##### ## ## ## ##### ######## ## ## ## ## ########### ## ## #
# ## ## ## ## ## ######## ## ## ##### ## ## ## ## ## ## ## ## ## ## ## ## ##### ##### ##### ## ## ## ########### ## ## #
#             ## ##                ##          ##       ##             ##    ##    ##       ##       ##          #     #
# ## ## ## ## ## ## ######## ##### ## ## ##### ## ## ## ## ## ## ## ## ## ## ## ## ## ##### ## ######## ## ## ## #######
# ## ## ## ## ## ## ## ##### ######## ## ##### ## ## ## ## ## ## ## ## ## ## ## ## ## ##### ## ######## ## ## ## #######
#                   ##          ##          ## ## ##  #    ##    ##             ##    ##    ##    ##       ##          #
# ## ## ## ## ##### ## ## ##### ## ######## ## ## ## ######## ## ## ##### ## ## ##### ## ##### ## ## ## ## ## ######## #
# ## ## ## ## ##### ## ## ##### ## ## ##### ## ## ## ##### ## ## ## ## ##### ## ##### ## ##### ## ## ## ## ## ######## #
#          ##                ## ## ##    ##  # #  ##       #  ##    ##                ##    ##          ##       ##    #
# ## ##### ## ## ## ## ##### ## ## ## ## ## ## ## ## ## ## ## ## ## ## ## ######## ## ##### ## ######## ## ##### ## ####
# ## ## ##### ## ## ##### ## ## ## ## ## ## ## ## ## ## ## ## ## ## ##### ######## ## ##### ## ######## ## ##### ## ####
#       ##       ##    #  ##    ##          ## ##       ##                      ## ##    ## ##          ##       ##    #
# ## ## ## ##### ## ## ## ## ## ## ## ## ## ## ## ## ## ## ## ## ## ## ## ##### ## ##### ## ########################## #
# ## ## ## ##### ## ## ## ## ## ## ## ## ## ## ## ##### ## ## ## ## ## ## ##### ## ##### ## ########### ############## #
#          ##    ##  # ##          ##       ## ##             ## ##          ## ##    ## ##          ## #  ##    ##    #
# ## ## ## ## ## ## ## ######## ## ## ## ## ## ## ## ## ## ## ## ## ##### ## ## ##### ## ########### ## ## ## ## ## ## #
# ## ## ## ## ## ##### ######## ## ## ## ## ## ## ## ## ## ## ## ## ## ## ## ## ##### ## ########### ## ##### ## ## ## #
# ##          ##                   ##       #  ##                ##          ##    ## ## ##    ##    ## ##    ##    ## #
# ## ## ## ## ## ## ## ## ## ## ## ## ## ## ## ## ## ########### ## ############## ##### ## ## ## ##### ## ######## ## #
# ## ## ## ## ## ## ## ## ## ## ## ## ## ## ## ## ## ########### ## ########### ## ##### ## ## ## ##### ## ######## ####
# ##    ##    ##  #       ##     # #  #  ##          ##          ## #        #  ## ##    ## #  ## ##    ##             #
# ## ## ## ## ## ## ##### ## ##### ## ## ## ## ##### ## ##### ## ## ######## ##### ## ##### ##### ## ################# #
# ## ## ## ## ## ## ##### ## ##### ## ## ## ## ##### ## ##### ## ## ######## ##### ## ########### ## ################# #
#    ##          ##       ##       ##       #        ##             ##    ##       ## #  ##       ## ## ##  #          #
#### ## ## ## ## ## ## ##### ## ##### ## ## ##### ##### ## ## ##### ## ## ########### ## ## ######## ## ## ## ##### ## #
#### ## ## ## ## ## ## ## ## ## ##### ## ## ##### ##### ## ######## ## ## ########### ## ## ######## ## ## ## ##### ## #
#    ##          ##        # ##                                     ## ##             ## ## ##       ##    ##    #  ## #
# ##### ##### ## ## ######## ## ## ## ## ##### ## ## ## ## ## ## ## ## ################# ## ## ################# ## ## #
# ##### ##### ## ## ######## ## ## ## ## ##### ## ## ## ## ## ## ## ## ################# ## ##### ############## ## ## #
#             #  ##          ##    ##          ## ##       ##  #    ##       ##        # ##    ##       ##       ##    #
# ## ## ## ## ## ######## ## ## ## ## ##### ## ## ## ## ## ## ##### ######## ## ######## ##### ######## ## ######## ####
# ## ##### ## ## ######## ## ## ## ######## ## ## ## ## ## ## ##### ######## ## ##### ## ##### ######## ## ##### ## ####
#    ##       ##          #     ##       ##     #       ##       ##    ##    ##       ## ##    ##       ## ## ## ##    #
# ## ## ##### ##### ## ## ## ## ## ##### ## ##### ##### ## ## ## ## ## ## ############## ## ##### ######## ## ## ## ## #
# ## ## ##### ##### ## ## ## ##### ##### ## ## ## ##### ## ## ## ## ## ## ############## ## ##### ######## ## ## ## ## #
#    ## ##          ##     #          ## ##    ##                ##    ##          ##    ##    ## ##  #    ##  #    ## #
# ## ## ## ##### ## ## ##### ## ##### ## ## ## ## ## ########### ## ## ########### ## ######## ## ##### ########### ## #
# ## ## ## ##### ##### ##### ## ##### ## ## ## ## ## ##### ##### ## ## ########### ## ######## ## ##### ##### ##### ## #
#    ##                      ##    ## ##             ##  #             ##       ## ##    ##    ## ##    ##    #  ##    #
# ##### ## ## ##### ##### ## ##### ## ########### ## ## ## ##### ## ## ## ##### ## ##### ## ##### ## ##### ##### ## ## #
# ##### ## ## ##### ##### ## ## ## ## ##### ##### ## ## ## ## ## ##### ## ##### ## ##### ## ##### ## ##### ##### ##### #
# ##       ##    ##     #       ##                    #       ##       ## ##    ##    ## ## ##    #  ##          ##    #
# ## ## ## ## ## ## ## ## ##### ##### ## ##### ######## ##### ## ######## ## ######## ## ## ############## ## ##### ## #
# ## ## ## ## ## ## ## ## ##### ## ## ## ##### ######## ##### ## ######## ## ######## ## ## ############## ## ##### ## #
#       ##    ## ##    #  ##                   ##    ##                ## ##       ## ## ##                            #
# ##### ## ##### ## ##### ## ## ## ## ## ## ## ## ## ## ## ## ######## ## ######## ## ## ######## ## ########### ##### #
# ## ## ## ## ##### ##### ## ## ## ## ## ## ##### ## ## ## ## ######## ## ######## ## ## ######## ## ##### ##### ##### #
#                            ##    ##    ##       ##    ##       ##    ##    ## ##    ##       ##    ##    ##    ##    #
# ## ## ## ##### ##### ##### ## ## ## ## ## ## ## ##### ## ##### ## ######## ## ############## ## ##### ##### ##### ####
# ## ## ## ##### ## ######## ## ## ## ## ## ## ## ##### ## ##### ## ######## #################### ########### ## ##### #
#    ##             ##                         ##          #  ##       ##    ##                ##             ##    ## #
# ## ## ## ##### ## ## ## ## ## ## ## ##### ##### ## ## ## ## ## ##### ## ##### ############## ## ################# ####
# ## ## ## ##### ## ## ## ## ## ## ## ##### ## ## ## ## ## ## ## ##### ## #################### ## ################# ####
#  # ##             ## ##    ##             #  ##       ##     #    ##    ##    ##    ##    ##    ##    ##       ##    #
# ## ## ##### ## ## ## ## ## ## ## ########### ## ## ## ## ##### ## ## ##### ## ## ## ## ## ## ## ## ## ## ##### ##### #
# ## ## ##### ## ## ## ## ## ## ## ########### ## ## ## ## ##### ## ## ##### ## ## ## ## ## ## ## ## ## ## ##### #######
#             #        ##     # ## ##          ##    ##          #           ## ## ## ## ## ## ## ## ##    ##    ##    #
# ##### ######## ## ## ## ## ## ## ## ## ## ## ## ## ## ##### ## ## ## ######## ## ## ## ## ## ## ## ######## ##### ## #
#### ## ######## ## ## ## ## ## ## ## ## ## ## ## ## ######## ## ## ## ######## ## ##### ## ## ## ## ######## ## ##### #
#              #             ## ##    #  ##    ## ##       ##    ##    ##    ## ##    ## ##    ## ## ##       ##    ## #
# ##### ## ## ## ## ## ##### ## ##### ## ## ## ## ## ## ## ## ##### ## ## ## ## ##### ## ##### ## ## ## ########### ## #
# ##### ## ## ## ##### ##### ## ## ## ## ## ## ## ## ## ## ## ## ## ## ## ## ## ## ## ## ##### ## ## ## ########### ## #
# ##    ## #  ##       ##       ##    ## ##          ## ##  #    ## ## ## ##    ## ##           #                   ## #
# ## ##### ## ## ## ## ## ##### ## ## ## ######## ## ## ## ## ##### ## ## ######## ## ##### ## ##### ######## ######## #
# ## ##### ## ## ## ## ## ## ##### ## ## ## ##### ## ## ## ## ##### ## A# ######## ## ##### ## ##### ######## ######## #
#E   ##  #       ##    ##       ##    ##              #    ##    ## ## ##       ## ##             ##          ##    ## #
# ##### ##### ## ## ## ## ##### ## ##### ########### ## ## ## ## ## ## ######## ## ##### ######## ## ######## ## ## ## #
# ## ######## ## ## ## ## ##### ## ##### ########### ## ##### ## ## ## ######## ######## ##### ## ## ######## ## ## ## #
# ## ##    ##           #          ##    ##                   ## ##    ##       ##    ##    #  ##    ##       ## ##    #
# ## ## ## ## ########### ## ##### ## ##### ## ## ## ##### ##### ## ## ## ######## ## ##### ######## ## ######## #######
####### ## ## ########### ## ##### ## ##### ## ## ## ##### ##### ## ## ## ######## ## ## ## ######## ## ##### ## ##### #
#       ##    ##          ##     #          ##    ##       ##    ##    ##       ## ## ##  #  #       ## #  ## ## ##    #
# ######## ## ## ## ## ## ## ## ######## ##### ## ##### ## ## ##### ## ######## ## ## ######## ######## ## ## ## ## ####
# ######## ## ## ## ## ## ##### ######## ##### ## ##### ## ## ##### ## ## ##### ## ## ######## ######## ##### ## #######
#          ##    ##    ##       #     ##                    # ##       #  ##    ## ## ##    ##    ##    ##    ## ##    #
# ## ## ## ## ## ## ## ## ## ## ## ## ## ## ######## ##### ## ## ########### ##### ## ## ## ##### ## ##### ##### ## ## #
# ## ## ##### ## ## ## ## ## ## ## ## ## ########### ##### ## ## ########### ##### ## ## ## ##### ## ##### ##### ## ## #
#       #     ##                    #    ##       ##       ##       ##       ##    ##    ## ##    #  ##    ##    ## ## #
# ## ## ## ## ## ## ##### ## ##### ######## ##### ##### ## ## ##### ## ######## ########### ########### ##### ##### ## #
# ## ## ## ## ## ## ##### ## ##### ##### ## ##### ##### ## ## ##### ## ## ##### ########### ############## ## ##### ## #
# ##                ##    ##       ##          ##       ##        # ## ## ##    ##       ##    ##       ## ##    ## ## #
# ## ## ##### ## ## ## ## ## ##### ## ######## ## ## ## ## ######## ## ## ## ##### ########### ## ##### ## ##### ##### #
# ## ## ## ## ## ## ## ##### ##### ## ## ##### ## ## ## ## ######## ## ## ## ##### ########### ## ##### ## ## ## #######
#                 # ##                   ##    #  ##    ##          ## ##  #    ##     #    ## ## ##    ## ## ## ##    #
# ##### ## ## ##### ## ## ##### ## ## ## ## ## ## ## ##### ##### ## ## ######## ######## ## ## ## ## ##### ## ## ## ## #
# ##### ## ######## ## ## ##### ## ## ## ## ## ##### ########### ## ## ######## ######## ## ## ## ## ## ## ## ## ## ## #
#                ##             ##          ##             ##    ## ##    #  ## ##       ## ##    ## ## ## ## ## ## ## #
#### ## ##### ## ## ##### ## ## ## ######## ## ## ## ##### ## ##### ##### ## ## ## ######## ######## ## ## ## ## ## ## #
# ## ## ##### ## ## ##### ## ## ## ######## ## ## ## ##### ## ##### ##### ##### ## ######## ######## ##### ## ## ## ## #
# ##       ##             ## ## ##              #    ##    ##    ## ##    ##    ##       ## ##    ## ##    ## ##    ## #
# ## ## ## ## ########### ## ## ## ## ############## ## ######## ## ## ##### ########### ## ## ## ## ## ##### ######## #
# ## ## ## ## ## ######## ## ## ## ## ############## ## ######## ## ## ##### ########### ## ## ## ## ## ############## #
# ##          ##             ## ##    #                 ##       ## ##       ##          ## #  #  ## ##       ##    ## #
# ######## ## ## ## ## ##### ## ##### ##### ## ## ## ##### ######## ########### ########### ######## ######## ## ## ## #
# ######## ## ## ## ## ##### ## ##### ##### ## ## ## ##### ######## ########### ########### ######## ##### ## ## ##### #
#                   ##          ##          #     ## #  ##    ##    #     ##  #    ##    ## ##    ## ##    ##    ##    #
####### ######## ## ## ## ######## ## ########### ## ## ##### ## ######## ## ##### ## ## ## ## ## ## ## ########### ####
####### ## ##### ## ## ## ######## ## ##### ## ##### ##### ## ## ## ##### ## ##### ## ## ## ## ## ## ## ######## ## ## #
#  #             ## ##  #    #     ##    ##    ##    ##    ## ## ##  #    #  ##    ## ##    ## ##    ##          ## ## #
# ## ##### ## ## ## ## ## ## ########### ######## ##### ##### ## ##### ######## ##### ######## #################### ## #
# ## ##### ## ## ## ## ## ## ########### ######## ##### ##### ## ##### ######## ##### ######## ## ################# ## #
# ##       ##                ##    ##    ##       ##  #    ## ##    ## ##       ##  # ##       ##  #          ##    ## #
# ##### ## ##### ##### ##### ## ## ## ##### ######## ##### ## ##### ## ## ######## ## ## ########### ######## ## ##### #
# ##### ##### ## ##### ##### ## ## ## ##### ######## ##### ## ##### ## ## ## ######## ## ########### ######## ## ##### #
#     #       ##                ##    #     ##       #   #    #     ##    ##          ##           #       ##    #     #
########################################################################################################################
