############################################################
############################################################
#                                                          #
# ## ## ## ## ## ## ## ######## ## ##### ## ######## ## ## #
# ## ## ## ## ##### ## ######## ## ##### ## ######## ## ## #
# ##        #                            ##                #
# ## ######## ## ##### ## ## ## ##### ## ## ## ## ##########
# ## ## ##### ## ## ## ## ## ## ######## ## ## ## ######## #
#        #    #        ##                      ##    ##    #
# ## ## ## ##### ## ## ## ## ## ## ## ######## ##### ## ####
# ## ## ## ##### ## ## ## ## ## ## ## ######## ##### ## ####
#          ##    ##    ## ##     #                      #  #
# ######## ## ## ## ## ## ## ## ## ######## ##### ##### ## #
# ## ##### ## ## ##### ## ## ## ## ## ##### ##### ##### ## #
#             ##       ##  #       ##                   ## #
# ## ##### ## ## ## ##### ## ## ## ## ## ## ######## ## ## #
# ## ##### ## ## ## ##### ## ## ## ## ## ## ## ##### ## ## #
# #        ##                ##             #  ##       ## #
# ##### ## ## ##### ## ## ## ## ########### ##### ##### ## #
# ##### ## ## ##### ## ## ## ## ########### ##### ##### ## #
#                      #           ##       ##    ##       #
# ## ##### ## ## ## ## ########### ## ######## ##### ##### #
# ## ##### ## ## ##### ########### ## ######## ## ## ##### #
#             ##    ##  #          ##  #    ##             #
# ## ## ## ## ## ## ##### ## ## ######## ## ## ## ## ## ## #
# ## ## ## ## ## ## ##### ## ## ## ##### ## ## ## ## ## ## #
#       #        ##                            #           #
# ## ## ## ######## ## ######## ##### ## ######## ## ## ## #
# ## ## ## ##### ## ## ##### ## ##### ## ######## ## ## ## #
#     #             ## ##          ##                      #
# ## ## ## ## ######## ## ## ## ## ## ## ## ## ## ## ## ## #
# ##### ## ## ######## ## ## ## ## ## ## ## ## ## ## ## ## #
#    ## ## ##             ##             ## ##          ## #
#### ## ## ######## ## ## ## ######## ## ## ## ## ## ## ## #
#### ## ## ######## ## ## ## ######## ## ## ## ## ## ## ## #
#                      ## ##          ##    ##    ##    ## #
# ########### ## ##### ## ######## ## ## ##### ## ## ## ## #
# ## ######## ## ##### ## ######## ##### ## ## ## ## ## ## #
# ##       ##                ##E   ##          ##    ##    #
# ## ##### ## ##### ######## ## ## ## ##### ## ## ## ## ## #
# ## ##### ## ##### ######## ## ## ## ##### ## ## ## ## ## #
#       ## ##       ##    ## ##    ##       ##     #    ## #
# ##### ## ## ## ## ## ## ## ## ##### ## ## ## ##### ## ## #
####### ## ## ## ## ## ## ## ## ##### ## ## ##### ## ## ####
#       ##    ##  #          ##                   ##       #
# ##### ######## ########### ## ########### ## ## ## ##### #
# ## ## ######## ########### ## ########### ## ## ## ##### #
# ## ##    ##       ##                #   #    ##          #
# ## ## ## ## ##### ## ##### ######## ##### ## ## ## ## ## #
# ## ## ## ## ##### ## ##### ######## ##### ## ## ## ## ## #
#          ##       ##       ##  #          #        ##    #
# ##### ## ## ## ## ######## ## ## ## ## ## ## ## ## ## ## #
# #A### ## ## ## ## ## ##### ##### ## ## ## ##### ## ## ## #
#          ##       ##    ## ##    ##             ## ##    #
# ## ## ##### ## ## ##### ## ## ##### ##### ##### ## ## ## #
# ## ## ##### ## ## ##### ## ## ##### ##### ##### ## ## ## #
#          ##             ##    ##    ##    #  ## ##    ## #
# ## ## ## ########### ##### ## ## ## ## ##### ## ##### ## #
# ## ## ## ########### ##### ## ## ## ## ##### ## ##### ## #
#       ##                         ##           #          #
############################################################
