########################################################################################################################
#################################################################A######################################################
# #                  #             #      #                   ##     #          #  ##                                  #
# #################### ########### ######## ##### ## ## ## ## ## ## ## ## ##### ## ## ######## ######## ## ##### ## ## #
# #################### ########### ######## ##### ## ## ##### ## ## ## ## ##### ## ## ######## ######## ## ##### ## ## #
#          ##    ##    ##       ##       ##                   ##          ##       ##       #  ##       ##     #       #
########## ## ## ## ##### ##### ##### ## ## ## ## ## ##### ## ## ## ##### ## ############## ## ## ## ##### ## ######## #
########## ## ## ## ##### ##### ##### ## ## ## ## ## ##### ## ## ## ##### ## ############## ## ## ## ##### ## ######## #
# ##       ## ##    #  ## ##    #     ##       ##    ##                                     ##    ##    ##    #        #
# ## ######## ######## ## ## ##### ## ## ## ## ## ## ## ##### ## ##### ########### ########### ## ## ## ## ######## ## #
# ## ######## ######## ## ######## ## ## ## ## ## ## ## ##### ######## ########### ########### ## ## ## ## ##### ## ## #
# ## ##     # ##     #    ##       ##             ##    ##    ##                   ##          ##                ##    #
# ## ######## ############## ## ## ## ## ## ## ## ## ##### ## ## ## ##### ##### ## ## ######## ## ## ######## ##### ####
# ## ######## ############## ## ## ## ## ## ## ## ## ##### ## ## ## ##### ##### ## ## ######## ## ## ######## ##### ####
# ##    ##    ##    ##    ## ## ##       ##    ##          ##    ##       ##    ## ##             #           ## ##    #
# ##### ## ##### ## ## ## ##### ## ## ## ## ## ## ##### ## ######## ## ## ## ## ## ########################## ## ## ## #
####### ######## ## ## ## ##### ##### ## ## ## ## ## ## ## ## ##### ## ## ## ## ## ## ####################### ## ## ## #
#    ## ##       ##    ## ##             ## ##    ##                      ## #  ## ## ##       ##    ## ##    ##       #
# ## ## ## ############## ## ##### ##### ## ######## ## ## ## ## ##### ##### ## ## ## ## ##### ## ## ## ## ######## ## #
# ## ## ## ## ########### ## ##### ##### ## ## ##### ## ##### ## ##### ######## ## ## ## ##### ## ## ## ## ######## ## #
# ## ## ##    ##          ## ##    ##       ##       ##          ##                ##  #    ## ## ## ##  #    ##       #
# ##### ######## ########### ## ##### ######## ##### ## ########### ##### ## ## ########### ## ## ## ######## ## ## ## #
# ##### ######## ########### ##### ## ######## ##### ## ########### ##### ## ## ########### ## ## ## ######## ## ## ## #
#    ##          ##       ##    ##                             #          ## ##             ##    ##                   #
#### ############## ##### ##### ######## ########### ## ## ##### ## ## ##### ## ##### ## ########### ## ## ######## ## #
# ## ############## ##### ##### ##### ## ########### ## ## ##### ## ## ## ## ##### ## ## ########### ## ## ##### ## ## #
# ##    #  ##       ## ##       ##  #    ##    ##          ##  #    ##    ##    #  ## ##    ##    ## ##       #        #
# ##### ## ## ######## ########### ######## ## ## ## ## ## ## ##### ## ## ##### ##### ## ## ## ## ## ## ## ## ## ## ## #
# ##### ## ## #################### ######## ## ## ## ## ## ## ##### ## ## ##### ######## ## ## ## ## ## ## ## ## ## ## #
#  #    ## ## ##                               ##    ##    ## #  ##       #  ##    ##    ##    ## ##    #           ## #
#### ##### ## ## ######## ## ## ## ## ## ##### ## ## ## ## ## ##### ########### ## ## ########### ################# ## #
#### ##### ## ## ## ##### ## ## ## ## ## ##### ## ## ## ## ## ##### ########### ## ## ## ######## ################# ## #
#    ##  #    ## ## ##    ##       #        ##    ## ## ##  #    ##       ##          ##       ##    ##    ##    ##    #
# ##### ######## ## ## ## ## ##### ## ##### ##### ## ## ## ##### ######## ## ## ## ## ######## ##### ## ## ## ## #######
# ############## ##### ## ## ## ## ## ##### ##### ## ## ## ##### ######## ## ## ## ## ############## ## ## ## ## ##### #
#    ##       ##                ##       ##       ##             ##    ## ## ##    ##       ##       ## ## ## ##       #
#### ## ##### ########### ##### ## ##### ## ##### ## ############## ## ## ## ############## ## ## ## ## ## ## ## ## ## #
# ## ## ##### ## ######## ##### ## ##### ## ##### ## ########### ######## ## ############## ## ## ## ## ## ## ## ## ## #
# ##  # ##    ##                   ##    ## ##                   ##    ##    ##       ##       ## ##       ##          #
# ##### ## ######## ##### ## ######## ## ##### ######## ########### ## ######## ##### ## ## ## ## ######## ## ##### ## #
####### ## ######## ##### ## ##### ## ## ##### ##### ## ########### ## ######## ##### ## ## ## ## ## ##### ## ######## #
#    #  ##    ##                   ##          #        ##    ##    ##    ##  # #   # ## ##       ##       ##          #
# ## ######## ## ##### ######## ## ## ## ##### ##### ## ## ## ## ######## ## ## ##### ## ## ##### ## ## ## ##### ## ## #
# ## ######## ## ##### ######## ## ## ## ##### ##### ## ## ## ## ##### ## ## ## ##### ## ## ##### ## ## ## ##### ## ## #
# ## ##       ##                ## ##    #              ## ##    #     ## ## ##             ##                   ## ## #
# ## ## ######## ######## ## ##### ## ## ## ## ## ######## ############## ## ##### ## ######## ## ## ## ##### ## ## ## #
# ## ## ######## ######## ## ## ##### ## ## ## ## ######## ################# ##### ## ######## ## ## ## ## ## ## ## ## #
# ##    ##                                     ##        #       ##       ## ## ##             #  ## ##       #  ## ## #
# ######## ######## ## ########### ## ##### ##### ############## ## ##### ## ## ## ## ##### ## ## ## ## ## ## ## ## ## #
# ##### ## ########### ## ##### ## ## ##### ##### ############## ## ##### ## ##### ## ##### ## ## ## ## ## ## ## ## ## #
#    ##  #    ##  #    ##                   ##    ##          #  ##    ## ##    ## #              ## ##       ##    ## #
#### ######## ## ## ## ##### ######## ## ##### ## ## ######## ######## ## ##### ## ########### ##### ## ## ## ## ## ## #
# ## ######## ## ## ## ##### ## ##### ## ##### ## ## ######## ##### ## ## ##### ## ########### ##### ## ##### ## ## ## #
# ##       ## #  ## ##                ##       ##    ##     #    ## ## ## ##    ##                   #        ##    ## #
# ######## ## ##### ##### ## ## ## ## ## ## ## ######## ######## ##### ##### ############################# ## ## ## ## #
# ##### ## ## ##### ##### ## ##### ## ## ## ## ################# ##### ##### ########### ########### ##### ## ##### ## #
# ##    ## ##       ##    #     ##       ##    ##    ##    #   # ##    ##  #    ##    ##  #    ##          ##         E#
# ## ##### ############## ##### ## ##### ######## ## ## ## ##### ## ##### ######## ## ##### ## ## ##### ## ## ## ## ## #
# ## ##### ############## ## ## ## ## ## ########### ## ## ##### ## ##### ######## ## ##### ## ## ##### ## ## ## ## ## #
#    ##    ##    #   #    ##             ##       ## ## ##    ## ##       ##       ##       ## ## #                 #  #
####### ##### ## ##### ## ## ## ## ## ##### ##### ## ## ##### ## ########### ################# ## ## ############## ## #
####### ##### ## ##### ## ## ## ##### ## ## ##### ## ## ##### ## ########### ################# ## ## ############## ## #
#       #   # ##       ##    ##    ##    ## ##    #  ## ##    ##    ##       ## ##             ##    ##             ## #
# ########### ########### ## ## ## ## ## ## ########### ## ######## ## ######## ## ############## ## ## ## ## ## ## ## #
# ########### ########### ## ## ## ## ## ## ########### ## ######## ## ########### ############## ## ## ## ## ## ## ## #
#          ## ##       #  ##    ## #     ## ##                      ## ##    ##    ##    #           ## ##    ## ##    #
# ######## ## ## ##### ##### ## ## ## ## ## ## ######## ## ## ##### ## ## ## ## ######## ######## ## ## ######## ## ## #
# ######## ## ## ##### ##### ## ## ##### ## ## ######## ## ## ##### ## ##### ## ######## ##### ## ## ## ##### ##### ## #
#          ## ## ##    ##    ##       ##                ##          ##    ##    ##             ## ##       ##          #
# ## ## ##### ## ## ##### ## ## ## ## ## ## ## ## ##### ## ##### ## ##### ######## ##### ## ## ## ## ## ## ## ## ##### #
#### ## ##### ## ## ##### ## ## ## ## ## ## ## ## ##### ## ##### ## ##### ##### ## ##### ##### ## ## ## ## ## ## #######
#       ##  # ## ##       ##    ##          ##          ##    #        ##    ##                ## ##       ##          #
# ##### ## ## ## ##### ## ## ## ## ##### ## ## ## ## ######## ##### ## ##### ##### ## ##### ## ## ## ## ## ## ## ## ## #
# ##### ## ## ## ##### ## ## ## ## ## ## ## ## ## ## ## ##### ##### ## ##### ## ## ## ##### ## ## ## ## ## ## ## ## ## #
# ##    ##             ##  #             ##    ##    ##    #           ##    ##     # #     ##          ##    #  ##    #
# ## ## ## ########### ## ## ##### ## ## ## ## ## ## ## ## ##### ##### ## ######## ## ##### ## ## ##### ######## ## ## #
# ## ## ## ########### ## ## ##### ## ## ## ## ## ## ## ## ##### ##### ########### ## ##### ## ##### ## ######## ## ## #
#    ## ##              # #        ##  #    ## ##       ##    ##       ##                      ##    ##        #    ## #
# ## ## ## ##### ## ## ## ## ## ## ## ## ## ## ## ##### ##### ## ## ## ## ######## ##### ##### ## ## ## ## ## ## ##### #
# ## ## ## ##### ## ## ## ## ## ## ##### ## ## ## ##### ## ## ## ## ## ## ######## ##### ##### ## ##### ## ## ## ##### #
# ##  #       ##    ## ## #              ##                ##    #   #          ##     #        #          ##    ##    #
# ## ########### ## ## ## ########### ## ## ######## ## ## ## ## ## ## ## ##### ######## ## ## ## ## ##### ## ## ## ## #
# ############## ## ## ## ## ##### ## ## ## ######## ## ## ## ## ## ## ## ## ########### ## ##### ## ##### ## ## ## ## #
# ##             ##                ## ## ##          ##  #          ##    ## ##                    #          ## ##    #
# ## ##### ## ## ## ########### ##### ## ## ##### ## ## ## ##### ## ## ## ##### ## ## ## ##### ## ## ## ## ## ## ## ####
# ## ##### ## ## ## ##### ##### ##### ## ## ##### ## ## ## ## ## ## ## ## ##### ## ## ## ##### ## ## ## ## ## ## #######
# ## ##                               #        ## ##       #        ##  #       ##     #    #  ##    ##          ##    #
# ## ## ######## ## ## ##### ## ## ########### ## ## ##### ## ## ## ## ## ######## ##### ## ## ## ## ## ## ##### ## ## #
# ## ## ## ##### ## ## ##### ## ## ########### ## ## ##### ## ## ## ## ## ######## ##### ## ## ## ##### ## ## ## ## ## #
#          ##             ##       ##    #     ##                   ## #        ##    #                 ##    ##    ## #
########## ## ##### ##### ## ## ## ## ## ## ##### ##### ##### ##### ## ##### ## ##### ######## ## ## ##### ## ## ##### #
####### ## ## ########### ## ## ## ## ## ## ##### ##### ##### ##### ######## ## ## ## ######## ## ## ##### ## ## ##### #
#       ##    #                 ##                          #                         ##        #          #           #
# ## ##### ##### ## ########### ## ##### ## ## ##### ##### ## ## ## ## ## ## ## ## ## ## ## ##### ## ## ## ######## ## #
# ## ##### ## ## ## ######## ## ## ##### ## ## ## ## ##### ## ## ## ## ## ## ## ##### ## ## ##### ## ## ## ########### #
# ##              #             ##           #    ##          ## ##    #  ##       ##       ##    ##    ##             #
# ## ##### ########### ######## ## ## ## ## ## ## ##### ## ## ## ## ## ## ## ##### ## ##### ## ## ## ## ## ##### ## ## #
# ## ##### ########### ######## ## ##### ## ## ## ##### ## ##### ## ## ## ## ##### ## ##### ## ## ## ## ## ##### ## ## #
#       ##          ## ##          ##          ##                ##       ## ##          ##    ##                #     #
# ## ## ######## ## ## ## ## ## ## ## ##### ## ## ## ##### ## ##### ##### ## ## ######## ## ##### ##### ## ## ## ## ## #
# ##### ######## ## ## ## ## ## ## ## ##### ## ##### ##### ## ## ## ## ## ## ## ######## ## ##### ##### ## ## ## ## ## #
#    ##    #     ##       #     ##    ##                         ## ##       ## ##                      ##             #
# ## ##### ## ## ## ##### ######## ##### ##### ######## ## ## ## ## ## ##### ## ## ########### ##### ## ## ## ######## #
# ## ##### ## ##### ##### ######## ##### ##### ######## ## ## ## ## ## ## ## ## ## ##### ##### ######## ## ## ##########
# ## ##    ##       ##                   #   #                   ##       ## ##    ##          #        ## ##          #
# ## ## ## ## ##### ## ##### ## ########### ## ## ## ## ######## ## ## ## ## ######## ## ## ## ## ## ## ## ## ## ## ## #
# ## ## ## ## ##### ## ##### ## ########### ## ######## ######## ## ## ## ## ######## ## ## ## ## ## ## ## ## ## ##### #
#    ##    ##       ##       ##                ##                       # ##          #  ##    ##       ## ## #  ##    #
# ## ## ## ##### ## ## ## ## ## ## ## ## ## ## ## ## ## ## ## ##### ## ## ## ## ######## ##### ## ##### ## ## ## ## ## #
# ## ## ## ##### ## ## ## ## ## ## ## ## ## ## ## ## ## ## ######## ## ## ## ## ######## ## ## ## ##### ## ## ## ## ## #
#    ## ##  #    #        #     #        ##       #  ##          #     #     ##       ##        #       ##       ##    #
# ## ## ## ## ########### ## ## ## ## ## ## ##### ## ## ##### ## ## ## ##### ##### ## ## ######## ## ## ## ##### ##### #
# ## ## ## ## ########### ## ## ## ## ## ## ##### ## ## ## ## ## ## ## ##### ##### ## ## ######## ## ## ## ##### ##### #
# ##    ##             ##          #  ##          ##    ##     #    ##     #       ##    ##          ##       #        #
# ## ## ## ##### ##### ## ## ##### ## ######## ## ## ## ## ## ##### ## ## ######## ##### ## ######## ######## ## ## ## #
# ## ## ## ##### ##### ## ## ##### ## ########### ## ## ## ## ##### ## ########### ## ## ## ######## ##### ## ## ## ## #
#    ##        # #     ##  #       ##          ##     #                               ##           #          ## ##    #
# ## ## ##### ## ## ## ## ## ## ## ######## ## ## ##### ##### ## ## ##### ## ## ## ## ## ##### ## ##### ##### ## ## ## #
# ## ## ## ## ## ## ## ## ## ## ## ######## ## ## ##### ##### ## ## ##### ## ## ## ## ## ##### ## ##### ##### ## ## ## #
#       #        ##                                                                                                    #
########################################################################################################################
