################ ######## ################# ############## ##### #########################
     ##    ##        #  # ##    ##  # ##                ##    ##   A##    ##        #    #
# ########### ## ##### ############## ## ## ########### ## ## ## ## ################# ####
# ########### ## ##### ## ######## ## ## ## ##### ##### ## ##### #################### ####
              ##    #  ##    #     #  ##       ## ## ##  #    ## #      # ## ##    ## #  #
# ##### ## ######## ##### ## ## ######## ## ## ##### ##### ##### ######## ## ##### ## ## #
# ##### ## ## ##### ######## ## ##### ## ## ######## ## ##### ## ######## ## ## ## ## ## #
#  # ##  # ## #  #  ##  # ##  #  # ##  # ##    ## ##     #  #     #    #  ##  # #   # ##  
#### ########### ##### ## ##### ## ## ## ##### ## ## ##### ##### ############## ## #######
#### ## ######## ##### ######## ## ## ######## ##### ## ## ##### ## ########### ## #######
#    #      # ##       ##  # #  ## ## #  ## ## #  ## #  #     #  ## #  ##    ## ##  #    #
# ##### ## ## ############## ## ## ## ## ## ## ## ## ## ######## ########### ## ## ## ####
#### ## ## ##### ########### ## ## ##### ##### ## ##### ######## ########### ##### ## ####
# ## ##    #  ##    #  ##  # ## ## #  ##    ## ##  #  # ## ##  # E#    #  ##  # #        #
# ## ######## ##### ######## ##### ##### ## ## ##### ## ## ## ##### ##### ##### ######## #
# ## ######## ##### ##### ## ## ######## ######## ## ##### ## ########### ##### ######## #
# ## #      #    #  ##  # #  #        #     ##          ##    ##    ##     #  # ##  # ## #
#### ##### ########### ## ##### ##### ##### ## ######## ########### ##### ## ## ## ## ####
#### ## ## ##### ##### ## ##### ##### ##### ## ########### ######## ##### ## ## ## ## ####
#       ##       ##  #        # ## #   #  #  # #  #        ##    #      #             ## #
# ## ######## ##### ##### ##### ## ########################## ################# ######## #
