############################################################
###A########################################################
#             ##    ##      E   #        ##    ##    ##    #
# ########### ##### ## ######## ######## ## ## ## ## ## ## #
# ########### ##### ## ######## ######## ## ## ## ## ## ####
#    #  ## ##                ##    ##  # ## ##    ## ##    #
# ## ## ## ##### ## ######## ##### ##### ## ######## ##### #
# ## ## ## ##### ## ######## ##### ##### ## ######## ## ## #
# ## ##    ##             ##    ##    ## ## ##       ## ## #
# ## ######## ##### ##### ##### ##### ## ## ## ######## ## #
# ## ######## ##### ######## ## ##### ## ## ## ######## ## #
# ##          ##             ## #  ## ##    ## #        ## #
# ## ## ##### ## ##### ######## ## ## ######## ########### #
# ## ## ##### ## ##### ######## ## ## ######## ########### #
# ##    ##    #               #    ## ##    ##    ##    ## #
# ## ######## ## ## ################# ## ## ##### ## ## ## #
# ## ######## ## ## ################# ## ## ##### ## ## ####
#             ##             ##       ## ##    ##    ##    #
# ## ##### ## ## ######## ## ## ######## ##### ########### #
# ## ##### ##### ######## ## ## ######## ##### ########### #
#    ##    ##    ##    ## ##    ##       ##  #  #       ## #
# ## ## ## ## ##### ## ## ## ##### ######## ##### ######## #
# ## ## ## ## ##### ## ## ## ## ## ############## ######## #
# ##    ##    ##    ## ##  # ## ## ## ##  #    ##       ## #
# ########### ## ##### ##### ## ## ## ## ## ########### ## #
# ########### ## ##### ##### ##### ## ## ## ########### ## #
#             ##             ##    ##    ##    #  ##  #    #
########## ## ## ## ##### ## ## ############## ## ## #######
########## ## ## ## ##### ## ## ##### ## ##### ## ## #######
#    ##          ##             ##    ##    ## ##    #  ## #
# ## ## ######## ########### ##### ######## ## ######## ## #
# ## ## ######## ## ######## ##### ######## ## ######## ## #
# ## ## ##       ## ##    ## #  ##    ##    ##    #  ## ## #
#### ## ## ######## ## ## ## ## ##### ## ######## ## ## ## #
#### ## ## ########### ## ## ## ##### ## ######## ## ## ## #
#    ##    ##    ##    ##    ##    ## ##       ## ##  #    #
# ########### ## ## ############## ## ######## ## ##########
# ########### ## ## ############## ## ########### ######## #
#           # #  ##    ##     #    ##          ##    #     #
############# ######## ## ##### ############## ##### #######
###################### ## ## ## ############## ##### #######
#             ##       ## ## ## ##          ## #  ##       #
# ########### ## ######## ## ## ## ######## ## ## ######## #
# ########### ## ## ##### ## ## ## ######## ## ########### #
# ##    ##    ## ##    ## ## ## ##       ##    ##       ## #
# ## ## ## ##### ##### ## ## ## ######## ######## ##### ## #
# ## ## ## ## ## ######## ## ##### ##### ######## ######## #
# ##  #    #  ##    ##    ## ##    ##    ##    ## ##    ## #
# ################# ## ##### ## ##### ##### ## ##### ## ## #
# ################# ## ##### ######## ######## ##### ## ## #
# ##                ##       ##    ## ##    ##       ## ## #
# ## ########################## ## ## ## ## ########### ## #
# ## ########################## ## ## ## ## ########### ## #
# ##    ##  #       ##       ## ##  #    ## ##    ##    ## #
# ##### ## ## ##### ## ##### ################# ## ## ##### #
####### ## ## ##### ## ##### ################# ## ## ## ## #
#       ## ##    ## ## ##  # ##       ##    ## ## ##    ## #
# ############## ## ## ## ## ## ##### ## ## ## ## ######## #
# ############## ## ## ## ## ## ##### ## ## ## ## ######## #
#                ##    ##    #  ##    #  ##    ##          #
############################################################
