############################################################
  #A             ##                                        #
# ##### ## ## ## ## ## ## ## ## ##### ## ## ########### ## #
#    ##    ## ##    ##    ##             ##             ## #
# ## ## ## ## ## ## ## ##### ## ## ## ## ## ## ## ## ## ## #
#  # ##    ##           #    ##    ##          ##          #
# ## ##### ######## ##### ##### ##### ## ##### ## ## ##### #
#        #                #                          ##    #
# ## ## ## ## ##### ## ## ## ## ## ## ## ######## ## ## ## #
#          ##                   ##    ## ##       ##    ## #
# ## ##### ## ######## ##### ## ## ## ## ## ##### ######## #
# ##       #        ##             ##    ## ##             #
# ## ## ##### ## ## ## ## ## ##### ## ## ## ## ##### ##### #
#    ##          ##                ##    ## ##       #     #
# ## ##### ##### ######## ######## ## ## ## ## ## ##### ## #
#                ##    ##          #           ##    ##    #
# ## ## ##### ## ## ## ## ## ##### ##### ##### ## ## ## ## #
#             ##    ##    ##                      ##    ## #
# ##### ## ## ## ##### ## ## ## ##### ## ######## ##### ## #
#     #    ##             ## ## ##     #                   #
# ## ## ## ## ##### ## ## ## ## ## ## ## ##### ## ## ## ## #
#    ##    ##              #             ##        # #  ## #
# ##### ## ## ## ##### ## ## ##### ##### ## ##### ## ## ## #
#          ##          #     #  ##       #        ##    ## #
# ## ## ## ## ## ##### ## ## ## ## ## ## ## ##### ##### ## #
# ## ##    ##          #  ##             ##       ##       #
# ## ## ##### ## ## ## ## ## ## ######## ## ## ## ## ## ## #
# ##          ##       ##     #          #  ##    ##    ## #
# ## ## ## ##### ##### ## ##### ## ## ##### ##### ## ## ## #
#     #                                                    #
#### ## ##### ##### ################# ## ##### ## ## ## ## #
#    ##    ##                   #              ##       ## #
# ## ##### ## ## ## ## ## ## ## ## ## ## ## ##### ## ## ## #
# ##    #  ##       ##       ##       ##             ## ## #
# ##### ## ## ##### ## ## ## ## ##### ##### ## ## ##### ## #
#     #    ##                                           ## #
# ## ## ## ## ## ##### ## ## ##### ##### ##### ## ## ##### #
# ##    ##           #    ##       #        ##     #    ## #
# ## ## ## ##### ## ## ## ## ## ## ## ##### ## ##### ## ## #
#                           E      #         #             #
############################################################
