##########################################################################################
#A                                                                                       #
######################################################################################## #
#                                                                                        #
# ########################################################################################
#                                                                                        #
######################################################################################## #
#                                                                                        #
# ########################################################################################
#                                                                                        #
######################################################################################## #
#                                                                                        #
# ########################################################################################
#                                                                                       E#
