##############################
###A##########################
# ##          ##            E#
# ##### ##### ## ## ## ## ## #
# ##### ##### ## ## ## ## ## #
#          ##             ## #
# ## ## ## ## ## ##### ## ## #
# ## ## ## ## ## ##### ## ## #
# ##       ##             ## #
# ## ##### ## ## ## ## ## ## #
# ## ##### ##### ## ## ## ## #
# ##    #        ##          #
# ## ## ## ## ## ## ## ##### #
# ## ## ## ## ## ##### ## ## #
#    ##                   ## #
# ## ## ## ######## ##### ## #
# ## ## ## ######## ##### ## #
#    ##          ##          #
# ## ## ##### ## ## ## ##### #
# ## ## ##### ## ## ## ##### #
#     #    ##     #     #    #
# ## ##### ## ##### ## ## ## #
# ## ##### ## ## ## ##### ## #
#             ##          ## #
# ##### ## ## ## ##### ##### #
# ##### ## ## ## ##### ##### #
#       ##  #          ##    #
# ## ## ## ## ##### ## ## ####
# ## ## ## ## ##### ## ## ## #
#                            #
##############################
