############################################################
############################################################
# ##                            ##                         #
# ## ######## ## ## ## ## ## ## ## ##### ##### ## ## ## ## #
# ## ######## ## ## ## ## ## ## ## ##### ##### ## ## ## ####
# ##E   ## ##    ##    ##                         ##  #    #
# ##### ## ## ## ## ##### ## ## ##### ##### ######## ## ## #
# ## ## ## ## ## ## ##### ## ## ##### ##### ######## ## ## #
# ## ## ##    ##          ##                       #    ## #
# ## ## ##### ## ## ## ## ## ## ## ##### ## ## ## ## ##### #
# ## ## ##### ## ## ## ## ## ## ## ## ## ##### ## ## ##### #
# ## ##    ##    ##    ##                      ##          #
# ######## ##### ## ##### ## ## ## ## ## ## ## ## ##########
# ######## ##### ## ##### ## ## ## ## ## ## ## ## ## ##### #
#       ##    ##                #        ## ##             #
####### ##### ## ## ## ######## ##### ## ## ## ##### ## ## #
####### ##### ## ## ## ######## ##### ## ## ## ##### ## ## #
#    ##       ##     #          #  ## ##    ##             #
# ## ########### ################# ## ## ## ## ## ## ## ## #
# ## ########### ################# ## ## ##### ## ## ## ## #
# ## ##       ##          ##     # ## ##    ##             #
# ## ## ##### ########### ## ##### ## ## ## ## ## ## ## ## #
# ## ## ##### ########### ## ##### ## ## ## ## ## ## ## ## #
# ## ##    ##             ## ##  #  #    ##       #        #
# ## ##### ################# ## ########### ##### ##### ## #
# ######## ################# ## ########### ##### ##### ## #
#  #    ## #   #       ##    ## #  ##    ##    ##       ## #
#### ##### ##### ##### ## ##### ## ## ## ## ## ## ## ## ## #
# ## ##### ##### ##### ## ##### ## ## ## ## ## ## ## ## ## #
# ##       ##    ##    ##       #  ## ##    ##       ##  # #
# ########### ##### ################# ######## ##### ## ## #
# ########### ##### ################# ######## ##### ## ## #
# ##  #       ##  #                   ##    ##    ##    ## #
# ## ## ######## ####################### ## ##### ## ## ## #
# ## ## ## ############################# ## ##### ## ## ## #
# #  ## ##       ##    ##       #     ## ##    ## ## ##    #
# ##### ######## ## ## ## ##### ##### ## ##### ## ## ## ####
# ##### ######## ## ## ## ##### ######## ##### ## ## ## ####
#    ## ##    ## ## ##    #  ##          ##    ## ## ##    #
#### ## ## ## ## ## ######## ############## ## ## ## ## ## #
#### ##### ## ## ## #################### ## ## ## ## ## ## #
#    ##    ## ##  #       ##    ##    #  ##    ##       ## #
# ##### ##### ########### ## ## ## ## ##### ## ######## ## #
# ##### ##### ########### ## ## ## ## ##### ## ######## ## #
#    ##    ##       ##    ## ## ##          ##  #       ## #
#### ##### ######## ## ##### ## ## ##### ##### ## ## ## ## #
#### ##### ##### ## ## ##### ## ## ##### ##### ## ## ## ## #
# ## ##          ## ##    ## ## ##    ## ##    ##    ##    #
# ## ## ######## ## ##### ## ## ## ## ## ## ## ## ## ## ## #
# ## ## ######## ## ##### ## ## ## ## ## ## ## ## ## ## ## #
#        #          ##  #    ##    ## ##    ##    ##       #
# ######## ##### ##### ######## ## ## ########### ## ## ## #
# ######## ##### ##### ##### ## ## ## ########### ## ## ## #
#    ##    ##                   ## ##       ##          ## #
# ## ## ##### ########### ## ## ## ######## ## ## ## ## ## #
# ## ## ## ############## ## ## ## ######## ## ## ## ## ## #
  ## ##             ##          ##    ##    ## ##    ##    #
# ## ## ## ## ##### ## ## ## ######## ## ##### ## ## ## ## #
# ## ## #A ## ##### ## ## ## ######## ## ##### ## ## ## ## #
#       ##  #    ##    ##  #          ##     #             #
############################################################
