############################################################
###A########################################################
#    ## ##                  E         ##                   #
# ## ## ## ## ##### ## ## ## ######## ## ## ## ## ## ## ## #
# ## ## ## ## ##### ## ## ## ######## ## ## ## ## ## ## ## #
#    ##    ##             ##       ## ##       ##          #
# ########### ## ######## ## ##### ## ## ######## ## #######
# ##### ##### ## ######## ## ## ## ## ## ######## ## #######
#    ##     #     #       ## ##    ## ## ##                #
#### ## ## ## ##### ## ## ## ######## ## ## ############## #
#### ## ## ## ## ## ## ## ########### ## ## ############## #
#                   ##             ## ##       ##          #
# ##### ## ## ## ## ## ## ######## ## ######## ## ##### ## #
# ##### ## ## ## ## ##### ## ##### ## ######## ## ##### ## #
#                #  ##    ##    ## ##          ##          #
# ## ## ## ## ## ## ## ######## ## ## ## ######## ## ## ## #
# ## ## ## ## ## ## ## ######## ## ## ## ######## ## ## ####
#       #  ##    ##          ##       ##  #                #
# ##### ## ## ## ## ## ##### ## ## ## ## ## ## ##### ##### #
# ##### ## ## ## ## ## ##### ## ## ## ## ## ## ########### #
#          ##    ## ##    ##    ##    ## ##  #             #
# ## ## ## ## ## ## ## ## ## ## ## ## ## ## ## ##### ## ####
# ## ## ## ## ## ## ## ## ## ## ## ## ## ## ## ##### ## ####
#          ##       ##             #   #             ##    #
# ######## ## ## ##### ##### ##### ##### ## ## ## ## ## ## #
# ######## ## ## ##### ##### ##### ##### ## ## ## ##### ## #
#             ##    ##          ##          ##    ##       #
# ## ######## ## ## ##### ##### ## ## ## ## ## ## ## #######
# ## ##### ## ## ## ##### ##### ## ## ## ## ## ## ## ##### #
#           #    ##       ##    ## ## ##    ## ##    ##    #
# ##### ##### ## ##### ##### ## ## ## ## ## ## ## ## ## ## #
# ##### ##### ## ##### ## ## ## ## ## ## ## ## ## ## ## ## #
#                      ##           #          ##          #
# ## ##### ## ## ## ## ## ##### ## ## ########### ######## #
# ## ##### ## ## ## ## ## ##### ## ## ########### ## ## ## #
#  # #     ##                ##    ##                ##    #
# ## ## ##### ## ######## ## ##### ## ## ## ## ##### ## ## #
# ## ## ##### ## ######## ## ##### ## ## ## ## ##### ## ## #
#          ##          ##          #  ##                ## #
# ## ## ## ## ##### ## ## ## ##### ## ## ##### ######## ## #
# ## ## ## ######## ## ## ## ##### ## ## ############## ## #
#       ##       ##    ##          ##                      #
# ############## ## ######## ##### ##### ## ## ## ## ##### #
################ ## ######## ##### ##### ## ## ## ## ##### #
#             ## ## ##                   ##  #             #
# ########### ## ## ## ## ## ## ##### ######## ##### ## ## #
# ########### ## ## ## ## ## ## ##### ##### ## ##### ## ## #
#       ## ## ## ##    ##             #                    #
####### ## ## ############## ##### ## ## ## ## ######## ## #
####### ## ## ############## ##### ## ## ## ## ######## ## #
#    ##    ##       ##       ##       ##          ##    ## #
# ## ############## ## ######## ##### ## ## ##### ## ## ## #
# ## ##### ##### ## ## ######## ##### ## ## ## ## ## ##### #
# ## ##    ##    ## ## ##       ##             ##  #    ## #
# ## ## ##### ##### ## ## ######## ## ## ## ##### ##### ## #
# ## ## ##### ##### ## ## ######## ## ## ## ##### ## ## ## #
# ## ##    ## ##    ##    ##    ##                         #
# ## ##### ## ## ########### ## ########### ## ##### ## ## #
# ## ##### ## ## ########### ## ########### ## ##### ## ## #
#  #       #  ##             ##                      ##    #
############################################################
