############################################################
###A########################################################
#                           E   #  ##        #       ##    #
# ## ## ## ## ######## ######## ## ## ######## ##### ## ## #
# ## ## ## ## ######## ######## ## ## ######## ##### ## ## #
#     #                ## ##    ##    ##       #  ##    ## #
# ##### ##### ## ##### ## ## ########### ######## ######## #
# ########### ## ##### ## ## ########### ################# #
#                ##    #  ## ##  #       ##    ##       ## #
# ##### ## ## ## ## ## ##### ## ## ######## ## ## ##### ## #
# ##### ## ## ## ## ## ##### ## ## ######## ## ## ##### ## #
#    ## ##          ##       #  ## ##       ## ## ## ## ## #
#### ## ## ######## ## ## ######## ## ######## ## ## ## ## #
#### ## ## ######## ## ## ######## ######## ## ## ## ## ## #
#    ##             ## ## ##    #  ##    ##  # ##    ## ## #
# ######## ######## ## ## ## ## ##### ## ##### ######## ## #
# ## ##### ######## ## ## ## ## ##### ## ##### ##### ## ## #
# ##       ##       ## ##          ## ##    ##    ## ##    #
# ######## ## ## ##### ## ## ##### ## ##### ######## #######
# ######## ## ## ##### ## ## ##### ## ##### ######## #######
#    ##       ##                          #          #     #
#### ## ## ## ## ## ## ## ######## ## ## ################# #
# ## ## ## ## ## ## ## ## ######## ## ## ###################
# ## ## ##    ##                         #  ##             #
# ## ## ## ## ##### ## ## ## ## ## ######## ## ########### #
# ## ##### ## ##### ## ## ## ## ##### ##### ########### ## #
#  # ##       ##       ##    ##       ##    ##    ##    ## #
#### ## ## ##### ######## ## ## ## ##### ##### ## ## ##### #
#### ## ## ##### ######## ## ## ## ##### ##### ## ## ##### #
#    ## ##       ##       ## ##          ##    ## ## ##    #
# ##### ## ## ##### ##### ## ## ## ######## ##### ## ## ####
# ##### ## ## ## ## ##### ## ## ## ########### ## ##### ####
# ##    ##    ##    ##  #              #    ## ## ##    #  #
# ## ######## ## ## ## ##### ## ## ##### ## ##### ## ##### #
####### ##### ## ## ## ##### ## ## ## ## ## ##### ## ##### #
#    ##          ## ##     #    ## #  ## ## ##    ##    ## #
# ## ########### ## ######## ## ## ##### ## ## ######## ## #
# ## ## ## ######## ######## ## ## ##### ## ## ######## ## #
# ## ## ## ##       ##    ## ##    ##    ## ## ## ##    ## #
#### ## ## ## ######## ## ## ######## ##### ## ## ## ##### #
#### ## ## ## ######## ## ## ######## ##### ## ## ## ##### #
#    ##  # ##          ## ##    ##  #    ##    ## ##    ## #
# ######## ############## ##### ## ##### ######## ##### ## #
# ######## ############## ##### ## ##### ######## ##### ## #
#       ## ##          ## ##    #  #  ##       ##    ## ## #
####### ## ## ########### ## ################# ##### ## ## #
####### ## ## ########### ## ################# ## ## ## ## #
#       ##    ##       ## ##     #          ## ## ## ## ## #
# ############## ##### ## ######## ######## ## ## ## ## ## #
################ ##### ## ######## ######## ## ## ## ## ## #
#                #  ## ##    ##    ##    ##    ## ## ## ## #
# ################# ## ##### ## ##### ## ######## ## ## ## #
# ################# ## ##### ## ## ##### ######## ## ## ## #
#       ##     #    ##    ## ## ##    ## ##  #    ##    ## #
####### ## ##### ######## ## ## ##### ## ## ## ########### #
####### ######## ######## ## ## ##### ## ## ## ##### #######
#    ##          ##       ## ## ##    ##    ##    ##  #    #
# ## ############## ######## ## ## ############## ##### ## #
# ## ########### ## ######## ## ## ############## ##### ## #
# ##             ##          #  ##                #     ## #
############################################################
