############################################################
############################################################
#    ##     #          ##    #                  #       #  #
#### ## ##### ########### ## ## ## ## ########### ##### ## #
#### ## ##### ########### ## ##### ############## ##### ## #
# ## ## ##    ##          ## ##             ##    ##    ## #
# ## ## ## ##### ########### ## ## ## ##### ## ##### ##### #
#### ## ## ##### ########### ## ## ## ## ## ## ##### #######
#                            ##    ##        #    ##       #
# ##### ########### ## ## ## ##### ## ## ## ##### ######## #
# ########### ##### ## ## ## ## ## ## ## ## ##### ######## #
# ##                   #        ##                      ## #
# ## ##### ## ######## ## ## ## ## ## ## ## ######## ## ## #
# ## ##### ## ######## ##### ## ## ## ## ## ######## ## ## #
#    ##    ##    ##    ##    ##             #     ## ##    #
# ## ## ## ## ## ## ## ## ## ## ## ## ## ######## ## ## ## #
#### ## ## ## ## ## ## ## ## ## ## ## ## ######## ## ## ## #
#    ##       ##       ## ## ##                ##     # ## #
# ## ##### ## ## ##### ## ## ##### ## ## ##### ######## ## #
# ## ## ## ## ## ## ## ## ## ##### ## ## ##### ######## ## #
#       #   #          ##                #  ##       ## ## #
# ## ## ##### ## ## ## ## ##### ######## ## ## ## ## ## ## #
# ## ## ##### ## ##### ## ##### ######## ## ## ##### ## ## #
#    ##       ##                            ##          ## #
# ## ##### ## ## ## ## ##### ## ##### ######## ## ## ##### #
# ## ##### ## ## ## ######## A# ##### ######## ## ## ##### #
# ##           #             ##    ##             ##       #
# ##### ##### ## ##### ######## ## ## ## ######## ## ## ## #
# ##### ##### ## ##### ######## ## ##### ## ##### ## ## ## #
#    ##                         ##     #          #     ## #
# ## ## ## ## ## ## ## ## ## ## ## ## ## ##### ##### ## ## #
# ## ## ## ## ## ## ## ##### ## ## ## ######## ##### ## ## #
# ##             ##       ## ##    ##                      #
# ############## ## ##### ## ## ## ## ## ## ########### ## #
# ############## ## ## ## ## ## ## ## ## ## ########### ## #
# ##                ##        #    ## ##    #           ## #
# ## ## ## ## ## ##### ##### ## ## ## ## ## ## ## ## ## ## #
# ## ## ## ## ## ## ## ##### ## ## ## ## ## ## ## ## ## ## #
# ##             #     ##    ##       ## ##           #    #
# ## ##### ##### ##### ## ##### ## ## ## ## ## ##### ## ####
# ## ##### ##### ##### ## ##### ## ## ## ## ## ##### ## ## #
# ## ##          ##    ## ##              # ##             #
# ## ## ##### ## ## ##### ## ######## ## ## ## ## ## ## ## #
# ## ## ##### ## ## ##### ## ######## ## ## ## ##### ## ####
# ##    ##    ##    ##                 #    ##       ##    #
# ## ## ## ## ## ## ## ######## ## ## ## ## ########### ## #
# ## ## ## ## ## ## ## ##### ##### ## ## ## ## ######## ## #
# #   #          ##          ##    ##       #           ## #
# ## ## ######## ##### ## ## ## ##### ##### ######## ## ## #
# ## ## ## ##### ######## ## ## ##### ## ## ######## ## ## #
#       ##                   ##                         ## #
# ##### ## ## ## ## ## ## ## ##### ## ##### ## ## ##### ## #
# ##### ## ## ## ## ## ## ## ##### ## ##### ## ## ##### ## #
#       #  ##       ##    ##          #     ## ##          #
# ## ## ## ## ##### ## ## ## ## ## ## ## ## ## ## ## ##### #
#### ## ## ## ## ## ## ## ## ##### ## ## ## ## ## ## ##### #
#    ##    ##                ##    ##    ## ##    ##       #
# ## ## ## ## ## ########### ## ## ##### ## ######## ## ## #
# ## ## ## ## ## ########### ## ## ##### ## ## ##### ## ## #
#                                                          #
##############################################E#############
